{
  "type": "game",
  "view_size": 8,
  "tile_size": 100,
  "render": "pixel",
  "toolbox": [
    "move_up",
    "move_down",
    "move_right",
    "move_left"
  ],
  "map": [
    "................",
    ".d.%............",
    "................",
    ".###............",
    ".123............",
    "................",
    "................",
    "................",
    "................",
    "................",
    "................",
    "................",
    "................",
    "................",
    "................",
    "................"
  ],
  "land": [
    "................",
    ".111............",
    ".111............",
    ".111............",
    "................",
    "................",
    "................",
    "................",
    "................",
    "................",
    "................",
    "................",
    "................",
    "................",
    "................",
    "................"
  ],
  "extra": [{
    "x": 3,
    "y": 1,
    "link": "/maze/maze_hard/1"
  }],
  "tutorial": [{
    "msg": "튜토리얼 메세지",
    "img": "/img/profile.png"
  }, {
    "msg": "'아이템 가져오기' 블록으로 아이템을 가져와서 사용해보자~!"
  }]
}
