{
  "type": "game",
  "view_size": 8,
  "tile_size": 100,
  "render": "pixel",
  "toolbox": [
    "move_up",
    "move_down",
    "move_right",
    "move_left"
  ],
  "map": [
    "................",
    ".d..............",
    "................",
    ".###............",
    ".123............",
    "................",
    "................",
    "................",
    "................",
    "................",
    "................",
    "................",
    "................",
    "................",
    "................",
    "................"
  ],
  "land": [
    "................",
    ".111............",
    ".111............",
    ".111............",
    "................",
    "................",
    "................",
    "................",
    "................",
    "................",
    "................",
    "................",
    "................",
    "................",
    "................",
    "................"
  ]
}
