{
  "toolbox": [
    "move_forward1",
    "rotate_left",
    "rotate_right"
  ],
  "map": [
    "########",
    "########",
    "##....##",
    "##.##.##",
    "##.##%##",
    "##.#####",
    "##@#####",
    "########"
  ]
}
