{
  "toolbox": [
    "move_forward",
    "rotate_left",
    "rotate_right",
    "repeat"
  ],
  "map": [
    "###########",
    "#####%#####",
    "##.......##",
    "##.......##",
    "##.......##",
    "##.......##",
    "##.......##",
    "##.......##",
    "##...u...##",
    "###########",
    "###########"
  ],
  "tutorial": [{
    "msg": "앗! 별이 7칸 앞쪽에 있어"
  }, {
    "msg": "'반복'블록을 이용해서 앞으로 가보자!"
  }]
}
