{
  "toolbox": [
    "move_forward",
    "rotate_left",
    "rotate_right",
    "repeat"
  ],
  "map": [
    "###########",
    "#%.......%#",
    "#.........#",
    "#.........#",
    "#.........#",
    "#.........#",
    "#.........#",
    "#.........#",
    "#.........#",
    "#u.......%#",
    "###########"
  ],
  "tutorial": [{
    "msg": "별이 너~무 멀이 있잖아!"
  }, {
    "msg": "'이중반복'을 이용하면 쉽겠는걸?"
  }]
}
