{
  "toolbox": [
    "move_up",
    "move_down",
    "move_right",
    "move_left"
  ],
  "map": [
    "########",
    "#^^^^^^#",
    "#^@^%.^#",
    "#^.^^.^#",
    "#^.^^.^#",
    "#^....^#",
    "#^^^^^^#",
    "########"
  ]
}
