{
  "tile_size": 32,
  "render": "pixel",
  "toolbox": [
    "move_forward3",
    "rotate_left",
    "rotate_right",
    "repeat"
  ],
  "map": [
    ".xxxxxxxxxxxxxxxxxxx.",
    "y....e..e..e..e..e..y",
    "y...................y",
    "y...................y",
    "ye......x........x.ey",
    "y.x............x....y",
    "y...........x.......y",
    "ye.................ey",
    "y.............x.....y",
    "y......x............y",
    "ye..........x......ey",
    "y.....x.............y",
    "y........x..........y",
    "ye...x.........x...ey",
    "y.............x.....y",
    "y.......x...x.......y",
    "ye....x....x.......ey",
    "y...................y",
    "y....x..............y",
    "ye.......x.........ey",
    "y...................y",
    "y.......x...........y",
    "y.u...x.....ezgo.%..y",
    "y....e..e..e..e..e..y",
    ".xxxxxxxxxxxxxxxxxxx."
  ],
  "tutorial": [{
    "msg": "3 곱하기 5는?"
  }, {
    "msg": "직접 정답을 찾아보고"
  }, {
    "msg": "그 수 만큼 개미를 움직이면"
  }, {
    "msg": "쉽게 별을 먹을 수 있을거야!!!!!"
  }]
}
