{
  "tile_size": 32,
  "render": "pixel",
  "toolbox": [
    "move_forward2",
    "rotate_left",
    "rotate_right",
    "repeat"
  ],
  "map": [
    ".xxxxxxxxxxxxxxxxxxxxx.",
    "y......czkocpc........y",
    "y...........pc........y",
    "y.%bj.......pc........y",
    "y...........pc........y",
    "y..bh.......pc........y",
    "y...........pc........y",
    "y..bf.......pc........y",
    "y...........pc........y",
    "y..bc.......obj.......y",
    "y.....................y",
    "y..ba.................y",
    "y.....................y",
    "y..j..................y",
    "y.....................y",
    "y..h..................y",
    "y.....................y",
    "y..f..................y",
    "y.....................y",
    "y..c..................y",
    "y.....................y",
    "y.u...................y",
    ".xxxxxxxxxxxxxxxxxxxxx."
  ],
  "tutorial": [{
    "msg": "2를 9개 더하면?"
  },{
    "msg": "2 곱하기 9하고 똑같아!"
  },{
    "msg": "반복을 이용해봐 숫자는 9를 넣고!"
  }]
}
