{
  "toolbox": [
    "move_forward",
    "rotate_left",
    "rotate_right",
    "repeat"
  ],
  "map": [
    "###########",
    "###.....###",
    "##..##..#.#",
    "##...##.###",
    "##.#.....##",
    "##.#.##...#",
    "##.#.#.##.#",
    "##.#..#...#",
    "##.....#.##",
    "##.###.#%##",
    "##u########"
  ],
  "tutorial": [{
    "msg": "미로찾기를 해볼꺼야!"
  }, {
    "msg": "먼저 길을 찾은 후에 움직여 보자!"
  }]
}
