{
  "toolbox": [
    "move_forward",
    "rotate_left",
    "rotate_right",
    "repeat"
  ],
  "map": [
    "########",
    "#@######",
    "#..#####",
    "##..####",
    "###..###",
    "####.%##",
    "########",
    "########"
  ]
}
